1111111111111
1000001000001
1011101011111
1210001000001
1010111111101
1010111111101
1011101011101
1010000010001
1011111111101
1000001000101
1011101011101
1000100010001
1111111111111