1111111111111
1000001000001
1110111010111
1000100012001
1011101111101
1010001000001
1010111011101
1002100010101
1011101110101
1010101000101
1010001011101
1010001000001
1111111111111