1111111111111
1011101010101
1011101010101
1010101000101
1110101111101
1000101000101
1010101010101
1010101210121
1010101010101
1010001010101
1011111010101
1000000010001
1111111111111