1111111111111
1200100000001
1010111111101
1010100000001
1010101111101
1010001000101
1011111011101
1210000000001
1011111111101
1000000000101
1011111110101
1000001000101
1111111111111