1111111111111
1000000000001
1111111110101
1000000000101
1011111011111
1000100012001
1010111110101
1010000010101
1011111011101
1010000000101
1010111111101
1010000200001
1111111111111