1111111111111
1010001002001
1010101110101
1010101000101
1010101011101
1000101010001
1011111010111
1000100010101
1110101010101
1000121010001
1211111011101
1000000010001
1111111111111