1111111111111
1002000010001
1011111010101
1010001000101
1010111111101
1000100010001
1111101110111
1000100000101
1010101111101
1010100000101
1011111110101
1002000000001
1111111111111