1111111111111
1010000210001
1010111010101
1000001000101
1011111111101
1010000000101
1010111110101
1010021000001
1011101111111
1010100000001
1010111111111
1000000000001
1111111111111