1111111111111
1010000000001
1010111110101
1010120010101
1010101110101
1000001000101
1011111011101
1010100010001
1010101111101
1210101000101
1010101010111
1000100010001
1111111111111