3;2;2;3;2;2
1;3;0;1;2;2
1;1;2;3;2;0
1;3;0;0;3;0
1;2;2;3;2;1
1;2;1;0;3;0